{
  "geometry_set": "default_geo_set",
  "spawn_symbol_set": "default_spawn_symbols",
  "map": [
      "ﬆ﬈﬈﬈﬈﬈﬈﬈﬈﬈﬈﬈﬈﬈﬈﬈﬈﬈﬈﬈﬇",
      "﬋ ﬂﬃ              ﬓ ﬉",
      "﬋ﬂ﬏ﬀ ﬔ ﬂ﬊﬊ﬃﬂ﬊﬊﬊﬊﬊ﬃ  ﬉",
      "﬋ﬁ﬌ﬃ  ﬂﬄ﬐ﬆﬀ﬉﬐ﬆ﬇﬐﬐﬋  ﬉",
      "﬋ ﬁﬀ ﬂﬄ﬐ﬆﬀ ﬁ﬈ﬀ﬉﬐﬐﬋  ﬉",
      "﬋   ﬂﬄ﬐ﬆﬀ    ﬂﬄ﬐ﬆﬀ  ﬉",
      "﬋  ﬂﬄ﬐ﬆﬀ    ﬂﬄ﬐ﬆﬀ   ﬉",
      "﬋ ﬂﬄ﬐ﬆﬀ    ﬂﬄ﬐ﬆﬀ    ﬉",
      "﬋ ﬉﬐﬐ﬅ﬊﬊﬊﬊ﬃ﬉﬐﬐﬋     ﬉",
      "﬋ ﬉﬐﬐﬐﬐﬐﬐﬐﬋﬉﬐﬐﬋ﬂ﬊ﬃ  ﬉",
      "﬋ ﬁ﬈﬈﬈﬈﬇﬐﬐﬋﬉﬐﬐ﬅﬄ﬐﬋  ﬉",
      "﬋      ﬉﬐﬐﬋ﬁ﬈﬈﬈﬈﬈ﬀ  ﬉",
      "﬋  ﬑   ﬁ﬈﬈ﬀ  ﬕ    ﬒ ﬉",
      "﬋                   ﬉",
      "ﬅ﬊﬊﬊﬊﬊﬊﬊﬊﬊﬊﬊﬊﬊﬊﬊﬊﬊﬊﬊ﬄ"
  ]
}